OOOOOOOOOOO
O   O     O
O O O OOO O
O O O O   O
O OOO O O O
O     O O O
O OOO O O O
O   O O   O
OOO OOO O O
OS        E
OOOOOOOOOOO